


















F 0,0,0
C 0, 0,0     

WE                                                 textures/sisi.xpm
SO textures/griffith.xpm
EA textures/void.xpm
NO textures/guts.xpm 

111111111111111111111
1000000000000000000001
100000000000111111111
1000000000001
1000000000001
100000000001
100010000000111111111111
1001 1000000000000000001
1000100000000000000N001
100000000000000000000001
111111111111111111111111
